10111111111111111111111111111111111111111
10000000001000000000101000000010000010001
11101111101111111011101011101111101110101
10101000100000000010001010000000000010101
10101110101110111111101010111011111111101
10001000001000000000101010100000000000001
10101111111111101110101011111011111011101
10100000100000101010000000100000101000101
10111111111110101011111011111011101111111
10001000100010100000100010001010000000001
11101011111010101010111110101010101011101
10100010001000101010001010100010101010001
10101111101011111111111011101110111110111
10001000001000100000001010001000001000001
11101110111011101110111010111011111011111
10000010000000000010000010001000001010001
10111011111011101010111111101011101111101
10101010001010001010001000001010000000001
10101110111011111111101111111111111011101
10000000000000100000100000000000000000101
11101111111110101010111011111011111110101
10000000000010001010101010001010000000101
10111011101011111111101111101111111011101
10101010101000001000001010100000001010001
11101010101110101011101010111110101110101
10001000101010101000100000000000100000101
10101010101010111110111111101011101110101
10100010100010100000001010001000101010101
11101011101111101010111011111111101010101
10101010001000001010101010101000001010101
10111111101111111110101010101111101011111
10000000101000100010100010101010001000001
10111010111010101110111010101010111110111
10001010000010100010001010001000100010001
10111010111110101111101010101011111011101
10100010001000101000001010101000101000101
10101111101011101011101011101110101110101
10100010101000000010000010000010100000001
10101110101011111111101010101010101111101
10100010001000000010001000101010000010001
11111111111111111111111111111111111111101
