10111111111111111111111111111111111111111
10000000101000000000000000001000001010101
11101011101010111111111011101110111010101
10001000001010100000000010000010101000001
10111010111111111010111111111010101111101
10100010001000001010100010001000000000101
10111110111110101010101110101011111011101
10100000001000100010001000101010101010001
11101111101110101110111111101010101011101
10101000101010100010000010001000001000101
10101110101011101011111111101011101010101
10100000100010001000101000100000101010101
10101110101111101110101110101111111110101
10001010101010100010000010100010000000001
11111010101010101111111010111111111111111
10001010100000101000000000101000001000001
10111011111110101111111110101011101111101
10101000100000000000100000100000100010001
10101011101110111111101011111110101010111
10001010001010001010101000101000101000001
11101011111010111010101110101110111111101
10100000000000100010101000000010100000101
10111011101110101110101110101110101110111
10000010001010100000100010101000101010001
10101111111011111011101111101011101010111
10101010000000001000100010101000100010101
10111010101011111110111010111110101110101
10100010101000000000001010001000101000001
10111011111011101011111010111010111011111
10001010000010001010000010001010001000101
10111011111110101010111110111011111011101
10000010100000101010101000000000001000101
11111110101110111010101111101011111011101
10100000101000001000000010001010000000001
10111011101110101011101111111010101010101
10001000001010101010101000001000101010101
10101010111011111010101110101011101110111
10101010101000001000100000100000101000101
11101011101011101111101110111010111011101
10000000000000101000000010001010100000001
11111111111111111111111111111111111111101
