10111111111111111111111111111111111111111
10000000100010000000000010001000000000101
10111110111010111010111110111111111011101
10100000000000101010100000100000000000001
11101111111010101011101011111111111011101
10101000000010001010101000000000000010101
10101111111010111010111111101011111110111
10100000100010100010000000101000000000001
10111111111111101110111111101111101010111
10101000001000101000000000001000101010001
10101011101110101010111111101010111011111
10000000101000000010000010000010100000101
10111011101011111110101110101110101111101
10100000100010000010100010100010100000001
10111011111110111111101110101010111111101
10100010100010000010000010101010100000101
11111110111010111011101110101011111010111
10001000000000001000101000101000001010101
11101110111110111110101111101010111110101
10001000101010001000001000101010001000001
10101111101010111111111011111110101011111
10100000001000001010000000101000100000101
10111111111110111011101111101111111111101
10000000100000001010100000000000000010001
10111110111110111010101111101010111110101
10001010000010000000000010001010000000101
10111010111111111011111011101010101111111
10000010100000100000001000101010100000001
10101010101011111111101111101111111110111
10101010001010100000101000101010000010101
11111110101010111010111011101010101110101
10101010101010001010000010001000101010001
10101010101111101110111111101010111011101
10001010100000001000100000001010100010001
10111010111011101010111110111110111010111
10101010100010001010000010101000000000001
10101011101110111011111110101111111111101
10000000100010001000000000000000101000101
10101110101111111110111110111111101011101
10100010000000000000100000100000000000001
11111111111111111111111111111111111111101
