10111111111111111111111111111111111111111
10000010000010000000000000001010101000101
11101011101110111010111110111010101010101
10001010100010101010000010001000001010101
10101110111010101110111111101011111110101
10100000000000000010101000000000001000001
11111111101111111011101111101011111011101
10001010101010000010100000001000101010001
10101010101010111110111110111111101011111
10101000101000100010100000000010000000001
10101110111111101010101011111011111110101
10101000100000001010101000100000001000101
11101010101010111110111011111110111010101
10100010101010100000100000000010001010101
10101110111010111011101011101110111011111
10000010001010100000001010000010001000101
10101110101110111011111110101111101010101
10101000100000001010000000100000100010001
11101110101110111111111010101111111111101
10000010100010000000001010100010000000101
10111011111011111011101010101111101010101
10001000101010100010000010100010101010001
10111111101010111110101110111110111111101
10000010101000001000101010100000000010101
10101110101111111110111011101011101010101
10100000100000000000000010001000101000001
10111111111110111011111111101110111111101
10100010000000100010100010000010100000101
10111010111111111010101010111111101111101
10100000101000100010001010001010000000101
11111011101110111010111110101011111011101
10101010100010001000001000100010100000101
10101010101111101111111010101110111011111
10000010001000101000101010100000001000101
10101010101110101011101011111110111110101
10101000100010001000000000000010001010001
11101011111011101011101111101111101010101
10001010000010000000101000000010000010101
11101111111110101011101110111111101110111
10000010000000101010001000000000100000001
11111111111111111111111111111111111111101
