10111111111111111111111111111111111111111
10001000000000000000001000000000100000001
10111011101111111111101011111110101011111
10000010100000000010001000100000101000001
10111110111111111010111110101111101111101
10100000001000100010000010100010001010001
10101110111010101111111010111010111010111
10101010000010100000001000100010000010001
10101011111110111111101111111011111111101
10100010001000000010100000001000000000101
10111110101011111010111111101111111110101
10000000100010000010000000100000100010001
11111111111110111110111010111110101011101
10000010000010001000100010000010101010001
10111010111011101011101111111010101010111
10100010001010001010001000100010101000001
10111111101010111110101010111010111111111
10100000001010100010101010001010100000001
10101111111010101010101011101010101111101
10001000001000001010101010001010101000101
10111011101111111010101010111010101010101
10100010100000101010101010101010001010101
11101110111110101010111010101011111110101
10001000000010101010000010100010000010101
10111011101110101011101110101110111010101
10001000100000101000100010101000100000101
11101110111111101110101110101011111111101
10001000001000100010101000101010000000101
10111111101010111010111011101010111110101
10000000101010001010000010100010100010001
10111110101011101011111110111010111011101
10100010100010101000000000000010001000001
10101110111110101011111111111111101111111
10001000100000001000001000000000101000001
11111011111111101111101011111110101011101
10001010001000100010001010001000101010001
10111010101010111010111010111011101010101
10100000100010101010100010001000100010101
10111111111110101011101110101110111110101
10000000000000100000001000100000000000101
11111111111111111111111111111111111111101
