10111111111111111111111111111111111111111
10100000001010001010000000100000101000001
10111011111010111010111111101111101110101
10001010100010000000000000100010101010101
10111010101111111111101111111010101010111
10100010101000100010001010101010000010001
10101110101011111011101010101010111110111
10101010000000100000100000000000000000001
10101011111110101011101110111011111111101
10001010100000101010100010001010001010101
11101010111010111010101111111110111010111
10000000001010001000000000101000000000101
11101111111110101010111011101110101110101
10000010001000101010001000000000101010101
10111111101010111011101010111111111011101
10000000101010000010101010100000000000001
10101111101111101010111111111011101111101
10100010000010001000100000100000101010101
11111010111010111011101111101010111010111
10000010101010100000101010101010000010001
11111010101111111010101010101111101110111
10101000001000001010100000000010101010001
10101010111110111011101011111010111011101
10100010001010001000001000001000001000001
10101111111011101011111011111011111011101
10001010001010001010101000100000000000101
11101010111010111010101111111011111110111
10101010000000100000000000001000001000001
10101011101110111010101010101010101111101
10000000101010100010101010101010101010101
11111010101011111010111111111010111010111
10001010101000100010100010001010001000001
10101011101110111011101110111110111010111
10101000001000000000000000101000000010001
10111011101010111110101111101111101010111
10100010101010001010100000000000101010001
10111010111011111011111110111010101110101
10000010000000100010000010001010101000101
10111010111111101110111111111110111010111
10100000000000000000000000000010001010001
11111111111111111111111111111111111111101
