10111111111111111111111111111111111111111
10000000000000000000000000000000000000001
10101010101010111011111111111010111111101
10101010101010001010000000000010000010001
10111010111010111110111110101010101010101
10001010100010001000000010101010101010101
10111111111110101011101111111111101110101
10001000000000101000100000000000101000101
11101110101110101110101110101010101111101
10001000101000100010101000101010101000001
11101011101110111111111010111010111110101
10001010001000000000001010100010100000101
11111011101110101011101110101011101011101
10000010000010101010001000101000101000101
10101110101010101110111110101110101010101
10101000101010101000001000101000101010101
10101011101110101010101110101110111010111
10101010000010101010100010100010001010001
10101010101010101111101111111011101111101
10101010101010100000101000000010000000101
10101011101111111111111110101011111011111
10101010000010000000000000101000001000001
10101111111111101110111110101111111111101
10100010000000001000000010100000000010001
10101010111111111011111010111011101111101
10101010100000000000001010100010000000101
10101011101111101111111010111110111110101
10101010000010000000100010100000001000101
11101010111110111110101111111011101010101
10001010000010001000100000100000101010101
11101111111111111010101110111011101111101
10000000000000001010100010100010001000001
11101111111010101111101011111111101110111
10000000001010100010001010000000001000001
10111010101110111111101011111110101011101
10001010100010100000001000000010101000101
11101011101011101110111111111011111111111
10001000101000101000000000100000000000001
10111011111010111110111110101011111110111
10001000001010001000000010101000100000001
11111111111111111111111111111111111111101
