101111111111111111111
101000001010101000101
101011111010101110101
100000100010000010101
111011101111101010101
100000100000001000101
111010111111101110101
100010001000001000001
111011111111111010111
100000000000101010001
111011111111101010101
100010000010001010101
101110111011101011101
100000100010001000101
101110111011101110101
100010100000000000101
111011101011111111101
100010101000001000001
111010111010111110101
100000001010001000101
111111111111111111101
