10111111111111111111111111111111111111111
10100000000010001000000000101010100000001
10101111111011101011101110101010111110101
10101000000000001000100010101000101010101
10111110111010101011111010101110101010101
10001010001010101010001010001000100010101
10111011111110101111101010111011101111101
10000010000000101010000010100000101000001
11111010111110111010111011111110101011111
10100000101000000000100000000010000010101
10111110101110111110111011111110111010101
10000000001010100010100010000000100010001
10111110101011101011111011101011111110111
10001000101000101000101000001000100010001
10111011101110111110101110101111101010111
10100010000010001000000010100000001010001
10111011111110101111111011101110101111101
10100010000010100000100000100010101010001
11101011101011101111101111111111101011101
10001010101000000000001000000000001000001
11101110111011101111111011101110111011101
10000000001010000010001010000010101010001
10111111101011101110111111111111101110111
10101000000010001000000000001000100000001
10101011111111101111101011111011101111101
10100000100010100000001000100000100010001
11101010101010111111111011101011111110111
10001010001010100000000010001000000010001
10111010111110101110111111101011111010101
10101010001000100010001010001010000010101
11101011101110101110101011101011101110111
10001000101000001000101000101000101010001
10111110101110101111111011101111111011101
10100000100010100000101000000000001000101
10111011111111111010101010111110111011101
10100010100000100010000010001000001000101
10101110101110111011111011111111101010101
10101000000010101010000000000010001010001
10101110111111101010101111101110111110111
10000000000010000010100010001000000000001
11111111111111111111111111111111111111101
