101111111111111111111
101000001000101000101
101011101011101010101
100010000010000010001
111111101111111110101
101000000010001000101
101011111011101011101
101010000010000000101
101011111110101111101
101000100010101000101
101010101111111010101
100010100000100010001
111110101111101111111
100000101000100000101
111010101110101111101
100010000010100000101
111010111110101011101
100010100000001000101
101111111011101110101
100000000000100010001
111111111111111111101
