101111111111111111111
101010100010100000001
101010111010111011101
101000001010101010101
101010101010101110101
100010100010001010001
111111101110111010111
100000100000000000101
111010111010111111101
100010001010001000101
111011101110111011101
101010100000100010001
101010101010101011101
100000101010001010001
101111101011111110101
101000001000101000101
111010111110101110111
100010001000100010001
111011111111101110101
100000000000000000101
111111111111111111101
