101111111111111111111
101000000000100000001
101110101111101111111
100000101010001010001
111110111010101010101
100010101010101000101
101010101010111110111
101010000010101000001
101110101010101111101
100010101000000000101
101111111110111111101
101010000000101010001
101011101010101011101
100010001010000000101
101110111111101110101
101000101000101010101
101010101010111011101
101010000010100010001
101110111010101010101
100000100010001000101
111111111111111111101
