101111111111111111111
101000000010100000101
101010111110101110101
101010100000000010001
101110101110111110101
100000001000100010101
111011111011101111101
100000100000100010001
111011111110101010101
100010000010101010101
101110111011101110111
100010100000000000001
101111111010101110111
101000101010101000001
101010101111111011101
100010001010000010101
101111111010111110111
100000100010001000101
101110111010101011101
100010000010100000001
111111111111111111101
